W_S______W__
W_WW_WWWWW__
_____W___W__
_W___WW_____
___W_____W__
______W____E
