S______W____W
WWWWW_WWW_W_W
WWWWW_WWW_W_W
WWWWW_WWW_W_W
WWWWW_____W_E
